{
  width: 10,
  height: 10,
  tiles: [
    [0, 1, 0, 0, 2, 0, 1, 1, 0, 0],
    [1, 1, 2, 0, 0, 0, 2, 1, 1, 0],
    [0, 2, 2, 2, 0, 0, 0, 0, 1, 1],
    [0, 1, 1, 1, 0, 0, 0, 2, 2, 2],
    [0, 0, 1, 1, 1, 0, 0, 0, 2, 1],
    [2, 0, 0, 1, 1, 1, 0, 0, 0, 1],
    [2, 2, 0, 0, 1, 1, 1, 0, 0, 1],
    [1, 2, 2, 0, 0, 1, 1, 1, 0, 0],
    [1, 1, 2, 2, 0, 0, 1, 1, 1, 0],
    [0, 1, 1, 2, 2, 0, 0, 1, 1, 1]
  ]
  "units": {
    "3,3": "SMCV"
  }
  "SMCV": {
    "HP": 3000,
    "Armor": "Heavy",
    "Tier": 3,
    "Prerequisitie": "SSDP + SLAB + WARF",
    "Speed": 0.5,
    "Deploy": "SCYD",
    "Deploy_icon": "",
    "Image": "SMCV",
    "Animation": "",
    "Weapon": "NONE"
  }
}
